Source,Target,Type,Id,Label,Weight,matchid,teamid,matchperiod,eventtime,eventsubtype,x1,y1,x2,y2,delta x,delta y,abs delta y
2,9,Directed,13088,,1,7,Opponent7,1H,12.645769,Head pass,25,31,36,41,11,10,10
12,10,Directed,13089,,2,7,Opponent7,1H,1190.755734,Simple pass,60,95,55,75,-5,-20,20
11,12,Directed,13090,,4,7,Opponent7,1H,1203.420775,Simple pass,46,55,64,75,18,20,20
12,6,Directed,13091,,4,7,Opponent7,2H,1264.834991,Simple pass,54,59,71,47,17,-12,12
8,6,Directed,13092,,3,29,Opponent7,2H,2653.592732,Launch,16,51,69,56,53,5,5
4,6,Directed,13093,,6,29,Opponent7,2H,2277.857048,Head pass,31,82,45,76,14,-6,6
6,12,Directed,13094,,6,7,Opponent7,2H,1782.136909,Simple pass,55,52,54,18,-1,-34,34
12,13,Directed,13095,,1,7,Opponent7,1H,223.258998,Simple pass,67,54,71,30,4,-24,24
13,3,Directed,13096,,6,7,Opponent7,2H,1611.70801,Simple pass,62,2,47,7,-15,5,5
13,11,Directed,13097,,3,7,Opponent7,2H,2584.115759,Simple pass,75,78,71,94,-4,16,16
11,3,Directed,13098,,3,7,Opponent7,1H,1914.494859,Simple pass,86,15,97,10,11,-5,5
11,9,Directed,13099,,2,7,Opponent7,2H,485.715446,Simple pass,64,12,57,25,-7,13,13
8,4,Directed,13100,,2,29,Opponent7,1H,2099.764126,Simple pass,11,38,22,68,11,30,30
4,10,Directed,13102,,6,29,Opponent7,2H,1385.596992,Head pass,32,90,54,86,22,-4,4
3,6,Directed,13104,,5,7,Opponent7,2H,702.183129,High pass,11,1,43,36,32,35,35
2,11,Directed,13105,,4,7,Opponent7,2H,1195.154708,Simple pass,10,37,12,68,2,31,31
11,10,Directed,13106,,5,7,Opponent7,2H,1474.960197,Simple pass,35,58,38,35,3,-23,23
10,3,Directed,13107,,9,29,Opponent7,2H,140.735229,Simple pass,46,53,49,8,3,-45,45
3,10,Directed,13108,,7,29,Opponent7,2H,2855.600454,Head pass,15,40,25,55,10,15,15
10,4,Directed,13109,,8,29,Opponent7,1H,2724.858968,Simple pass,44,55,35,68,-9,13,13
4,2,Directed,13110,,5,29,Opponent7,2H,782.743915,Simple pass,55,80,50,19,-5,-61,61
2,10,Directed,13111,,5,29,Opponent7,2H,139.339385,Simple pass,34,28,46,53,12,25,25
10,9,Directed,13112,,6,7,Opponent7,2H,2082.716425,Simple pass,48,28,74,7,26,-21,21
9,10,Directed,13113,,4,29,Opponent7,1H,521.142682,Simple pass,90,0,84,16,-6,16,16
10,2,Directed,13114,,5,29,Opponent7,2H,578.337398,Simple pass,63,43,50,18,-13,-25,25
2,8,Directed,13115,,6,29,Opponent7,1H,2096.174767,Simple pass,39,5,11,38,-28,33,33
8,13,Directed,13116,,1,7,Opponent7,1H,693.041851,High pass,10,56,63,31,53,-25,25
4,11,Directed,13117,,3,7,Opponent7,2H,1128.431076,Simple pass,17,51,28,45,11,-6,6
11,4,Directed,13118,,5,7,Opponent7,2H,2576.475472,Simple pass,66,63,44,56,-22,-7,7
12,11,Directed,13122,,1,7,Opponent7,1H,727.941948,Simple pass,79,83,75,82,-4,-1,1
11,5,Directed,13123,,2,7,Opponent7,2H,1755.296607,Simple pass,7,92,15,83,8,-9,9
12,4,Directed,13124,,2,7,Opponent7,1H,1206.946922,Simple pass,60,74,34,73,-26,-1,1
3,9,Directed,13127,,6,29,Opponent7,1H,1514.976592,Simple pass,63,7,83,8,20,1,1
9,13,Directed,13128,,3,7,Opponent7,2H,1272.103339,Simple pass,71,4,75,28,4,24,24
10,6,Directed,13137,,2,7,Opponent7,2H,360.980948,Simple pass,33,56,48,55,15,-1,1
6,4,Directed,13138,,1,7,Opponent7,1H,878.188876,Simple pass,65,44,57,77,-8,33,33
10,13,Directed,13140,,3,7,Opponent7,2H,1610.56176,Simple pass,70,1,62,2,-8,1,1
13,6,Directed,13144,,1,7,Opponent7,1H,1168.075393,Simple pass,37,22,46,26,9,4,4
6,13,Directed,13145,,1,7,Opponent7,1H,1169.156434,Simple pass,46,26,54,34,8,8,8
10,11,Directed,13148,,3,7,Opponent7,1H,1217.515672,Simple pass,41,30,47,48,6,18,18
4,5,Directed,13160,,7,29,Opponent7,2H,1582.559681,Simple pass,40,91,36,99,-4,8,8
5,11,Directed,13161,,4,7,Opponent7,2H,2304.709812,Head pass,58,94,62,73,4,-21,21
11,6,Directed,13162,,2,7,Opponent7,2H,2585.505853,High pass,71,94,91,87,20,-7,7
12,3,Directed,13164,,2,7,Opponent7,2H,2088.095634,Simple pass,61,8,42,9,-19,1,1
6,9,Directed,13165,,2,7,Opponent7,2H,10.341265,Head pass,72,5,77,14,5,9,9
11,2,Directed,13168,,3,7,Opponent7,2H,460.657862,Simple pass,62,3,52,3,-10,0,0
8,12,Directed,13170,,1,7,Opponent7,1H,1507.225517,Launch,13,69,64,82,51,13,13
4,12,Directed,13173,,1,7,Opponent7,1H,1578.279029,High pass,20,78,69,91,49,13,13
3,2,Directed,13174,,6,29,Opponent7,2H,1203.001677,Simple pass,36,9,30,26,-6,17,17
5,6,Directed,13175,,4,29,Opponent7,2H,1681.425417,Cross,81,93,89,58,8,-35,35
6,10,Directed,13176,,2,7,Opponent7,2H,2081.108641,Simple pass,54,26,48,28,-6,2,2
11,8,Directed,13182,,1,7,Opponent7,1H,2154.843573,Simple pass,32,63,13,65,-19,2,2
8,2,Directed,13186,,8,29,Opponent7,2H,1664.210205,Hand pass,11,65,22,20,11,-45,45
10,8,Directed,13188,,1,7,Opponent7,1H,2338.83118,Simple pass,26,38,13,65,-13,27,27
5,12,Directed,13189,,4,7,Opponent7,2H,1260.384406,Simple pass,18,64,33,59,15,-5,5
12,5,Directed,13190,,3,7,Opponent7,2H,468.25531,Simple pass,79,93,52,81,-27,-12,12
10,12,Directed,13193,,1,7,Opponent7,1H,2562.902794,Simple pass,65,86,66,97,1,11,11
4,8,Directed,13197,,8,29,Opponent7,2H,376.370386,Simple pass,40,97,14,70,-26,-27,27
8,9,Directed,13202,,1,7,Opponent7,1H,2696.64756,Launch,13,76,67,62,54,-14,14
9,4,Directed,13203,,2,7,Opponent7,2H,487.869122,Simple pass,57,25,44,71,-13,46,46
8,3,Directed,13207,,1,7,Opponent7,2H,182.689472,Hand pass,7,56,39,3,32,-53,53
6,5,Directed,13209,,5,29,Opponent7,2H,2131.962403,Simple pass,50,96,28,96,-22,0,0
13,2,Directed,13212,,1,7,Opponent7,2H,380.976392,Simple pass,22,14,20,22,-2,8,8
2,5,Directed,13214,,1,7,Opponent7,2H,462.219361,High pass,52,3,66,92,14,89,89
5,4,Directed,13217,,5,29,Opponent7,1H,2295.133233,Simple pass,37,72,21,66,-16,-6,6
4,3,Directed,13218,,1,7,Opponent7,2H,475.440267,High pass,43,80,74,2,31,-78,78
9,11,Directed,13220,,1,7,Opponent7,2H,483.345876,Simple pass,61,19,64,12,3,-7,7
13,12,Directed,13237,,1,7,Opponent7,2H,1273.296834,Simple pass,75,28,96,20,21,-8,8
9,3,Directed,13239,,3,29,Opponent7,1H,1522.159408,Simple pass,87,6,91,1,4,-5,5
3,12,Directed,13242,,1,7,Opponent7,2H,1478.324476,Simple pass,28,10,42,3,14,-7,7
12,9,Directed,13243,,1,7,Opponent7,2H,1481.843635,Simple pass,42,3,75,22,33,19,19
2,12,Directed,13248,,1,7,Opponent7,2H,1699.931179,Head pass,14,34,35,15,21,-19,19
2,3,Directed,13252,,8,29,Opponent7,2H,1262.001932,Simple pass,57,29,63,6,6,-23,23
9,6,Directed,13254,,2,7,Opponent7,2H,2074.243186,Simple pass,35,24,63,16,28,-8,8
9,12,Directed,13258,,1,7,Opponent7,2H,2086.27548,Simple pass,74,7,61,8,-13,1,1
5,9,Directed,13260,,1,7,Opponent7,2H,2117.613026,Head pass,21,65,41,44,20,-21,21
10,5,Directed,13261,,6,29,Opponent7,2H,415.697644,Simple pass,57,80,47,87,-10,7,7
9,2,Directed,13267,,1,29,Opponent7,1H,0.111465,Simple pass,51,51,31,31,-20,-20,20
5,10,Directed,13268,,4,29,Opponent7,1H,2721.691766,Simple pass,53,84,44,55,-9,-29,29
2,7,Directed,13269,,1,29,Opponent7,1H,50.478887,Head pass,41,8,48,12,7,4,4
7,15,Directed,13270,,4,29,Opponent7,2H,766.029742,Simple pass,91,36,95,14,4,-22,22
15,9,Directed,13271,,2,29,Opponent7,1H,631.983367,Simple pass,93,14,95,4,2,-10,10
14,5,Directed,13272,,11,29,Opponent7,2H,981.942629,Simple pass,48,82,53,97,5,15,15
4,7,Directed,13273,,1,29,Opponent7,1H,170.912309,High pass,29,68,73,19,44,-49,49
9,15,Directed,13274,,4,29,Opponent7,1H,1635.642578,Simple pass,91,39,92,45,1,6,6
2,14,Directed,13277,,9,29,Opponent7,2H,388.658576,Simple pass,34,26,34,43,0,17,17
14,4,Directed,13278,,5,29,Opponent7,1H,2715.350904,Simple pass,55,47,41,58,-14,11,11
4,14,Directed,13279,,4,29,Opponent7,1H,1714.065686,Simple pass,48,49,53,76,5,27,27
1,7,Directed,13282,,3,29,Opponent7,2H,2872.637728,Simple pass,36,79,62,83,26,4,4
1,10,Directed,13284,,1,29,Opponent7,1H,270.174172,Simple pass,37,68,62,61,25,-7,7
10,7,Directed,13285,,3,29,Opponent7,2H,2857.586192,Head pass,25,55,40,61,15,6,6
7,9,Directed,13286,,1,29,Opponent7,1H,274.414895,Simple pass,75,37,80,15,5,-22,22
14,15,Directed,13294,,4,29,Opponent7,2H,1855.386196,Simple pass,60,19,93,18,33,-1,1
9,5,Directed,13295,,1,29,Opponent7,1H,338.13982,Smart pass,67,25,95,90,28,65,65
15,3,Directed,13296,,5,29,Opponent7,2H,574.035388,Simple pass,80,16,60,13,-20,-3,3
15,10,Directed,13299,,4,29,Opponent7,2H,925.045244,Simple pass,83,88,85,98,2,10,10
10,14,Directed,13302,,6,29,Opponent7,2H,775.774969,Simple pass,73,33,64,12,-9,-21,21
14,2,Directed,13303,,6,29,Opponent7,2H,777.354186,Simple pass,64,12,57,24,-7,12,12
2,4,Directed,13304,,3,29,Opponent7,2H,780.50846,Simple pass,57,24,55,80,-2,56,56
14,10,Directed,13306,,3,29,Opponent7,2H,1498.21514,Simple pass,42,83,55,98,13,15,15
4,1,Directed,13308,,4,29,Opponent7,2H,6.997924,Head pass,16,89,23,95,7,6,6
1,5,Directed,13309,,6,29,Opponent7,1H,2434.01216,Simple pass,76,94,64,93,-12,-1,1
10,15,Directed,13312,,3,29,Opponent7,2H,928.563675,Simple pass,85,98,64,97,-21,-1,1
3,15,Directed,13315,,3,29,Opponent7,1H,2598.615723,Simple pass,60,2,76,2,16,0,0
3,7,Directed,13318,,7,29,Opponent7,2H,1532.665883,Simple pass,42,6,88,12,46,6,6
5,1,Directed,13323,,4,29,Opponent7,2H,1584.266672,Simple pass,36,99,55,99,19,0,0
2,15,Directed,13325,,4,29,Opponent7,2H,2541.95074,Head pass,6,47,26,26,20,-21,21
15,2,Directed,13326,,2,29,Opponent7,1H,2087.411267,Simple pass,54,40,37,17,-17,-23,23
4,9,Directed,13327,,1,29,Opponent7,1H,951.273132,Head pass,39,69,65,63,26,-6,6
3,14,Directed,13331,,4,29,Opponent7,1H,2602.824272,Simple pass,67,2,51,4,-16,2,2
15,7,Directed,13333,,2,29,Opponent7,2H,751.428962,High pass,24,6,64,15,40,9,9
14,3,Directed,13354,,4,29,Opponent7,2H,1530.072791,Simple pass,34,21,42,6,8,-15,15
5,14,Directed,13364,,3,29,Opponent7,2H,982.647264,Simple pass,53,97,42,93,-11,-4,4
15,14,Directed,13365,,2,29,Opponent7,2H,770.064598,Simple pass,95,14,77,12,-18,-2,2
9,14,Directed,13367,,1,29,Opponent7,1H,1707.544681,Head pass,75,22,55,50,-20,28,28
5,7,Directed,13372,,3,29,Opponent7,2H,1244.086143,Smart pass,68,90,88,71,20,-19,19
7,5,Directed,13390,,1,29,Opponent7,1H,2111.516449,Simple pass,54,79,39,75,-15,-4,4
10,1,Directed,13398,,2,29,Opponent7,2H,411.011086,Simple pass,48,70,59,94,11,24,24
1,14,Directed,13399,,2,29,Opponent7,2H,860.251802,Simple pass,79,66,73,45,-6,-21,21
1,2,Directed,13404,,1,29,Opponent7,1H,2286.942991,Simple pass,36,32,25,23,-11,-9,9
5,8,Directed,13410,,5,29,Opponent7,2H,938.188461,Simple pass,33,96,10,79,-23,-17,17
8,10,Directed,13411,,1,29,Opponent7,1H,2563.423411,Launch,5,75,40,90,35,15,15
14,7,Directed,13412,,1,29,Opponent7,1H,2569.384818,Launch,36,70,70,79,34,9,9
5,2,Directed,13414,,2,29,Opponent7,2H,1196.314113,Simple pass,35,94,23,33,-12,-61,61
6,1,Directed,13455,,2,29,Opponent7,2H,759.852168,Simple pass,79,44,88,70,9,26,26
14,6,Directed,13462,,1,29,Opponent7,2H,748.190922,Head pass,17,18,30,19,13,1,1
6,15,Directed,13463,,2,29,Opponent7,2H,945.450131,Simple pass,69,71,65,77,-4,6,6
1,6,Directed,13466,,2,29,Opponent7,2H,1585.251318,Simple pass,55,99,64,94,9,-5,5
15,5,Directed,13479,,1,29,Opponent7,2H,929.877587,Simple pass,64,97,64,83,0,-14,14
2,6,Directed,13489,,2,29,Opponent7,2H,1673.731879,High pass,48,26,68,76,20,50,50
1,15,Directed,13491,,1,29,Opponent7,2H,1248.834303,Cross,98,90,87,32,-11,-58,58
7,6,Directed,13494,,3,29,Opponent7,2H,2876.203125,Simple pass,62,83,70,41,8,-42,42
8,14,Directed,13507,,1,29,Opponent7,2H,1849.739674,Hand pass,9,31,34,24,25,-7,7
6,7,Directed,13510,,1,29,Opponent7,2H,2150.340531,Head pass,46,82,59,82,13,0,0
7,1,Directed,13511,,1,29,Opponent7,2H,2151.647962,Head pass,59,82,43,93,-16,11,11
15,6,Directed,13515,,1,29,Opponent7,2H,2543.753447,High pass,26,26,68,28,42,2,2
3,1,Directed,13519,,1,29,Opponent7,2H,2869.901406,Head pass,20,48,36,79,16,31,31
